14,10
WWWWWWWWWW
W_p__BBB_W
W________W
W________W
W________W
W________W
W________W
W________W
W________W
W________W
W___m____W
W_m_m_m__W
W________W
WWWWWWWWWW